1111111111111111111111111
1200000111111111111100021
1200000111111111111000011
1110000111111111111000011
1111000011111111110000011
1110000000001111110011001
1100000000001111010010011
1100011110111111111010011
1100011111120000001100111
1100111111200000001100011
1100012000111111111000011
1100011001100000000110011
1100110011000000000110001
1100111100000000001100001
1100121100000000001100101
1000011100000000001100111
1010000001100000001100111
1011000000111000001100111
1011100011111111111001101
1011112000011111110011001
1000021100000000000000111
1111111100100000000000001
1000011001001100111110011
1011010001001100111100001
1010000121001100002110001
1010001101001111111000011
1001111000000000021200111
1100000000111111111011011
1100000000000000000000001
1111111111111111111111131